********************* *******************************************************************************
*                       *   *             *       *       *   * *               *             *     *
* *** ************* *** * * * *** ***** ********* *** *** * * * * ***** *** * *********** * * ***** *
*   *   *   *   * * *     *   *   *   *   * *   *       *   *       * * *   * *   * *   * * *     * *
* *** * *** * *** *** ***** ******* *** * * *** ***** ******* *** * * * *** *** *** * *** * *** * * *
* * * * *     *     * *   *       *   * *       *     * *     *   *   *   *   * * *         *   * * *
* * ***** *** ***** *** *** ******* *** *** ***** * * * ***** *** ***** * *** * * * ************* * *
*   * *   *         *         *     * * * *     * * * *     * *   *     * *       * *       *       *
*** * * ******* ***** ***** ******* * * * * *** ***** *** ***** ********* * * * *** * ***** *** * ***
* * *   * *   *   * * * *     *     *   * *   * *     * *   *       *     * * *   * *     *   * *   *
* * * *** * *** *** * * *** *** ********* *** ******* * * *** ***** ***** ******* * *** * * *** * ***
*   * * *           * *     *   * *   *                   *     *   *     *     *   *   * * *   * * *
* * *** * ***** *** * * * *** *** *** ***** ***** ********************* ***** *** * ***** *** * *** *
* *     *   * * *     * *         *         *           *         *   *       *   *     * *   *     *
* *** *** *** * ************* * * * ******* ***** *********** ***** ******* ********* *** * *********
*   * *   * *             *   * * *       * *   *   * *   *       * *   *   * * * *     *           *
* ***** *** *** * * * * * * ***** * * ******* * * *** * *** ***** * * * * * * * * *************** * *
* *   * *       * * * * * *   *   * *     * * * *   *   *     *     * *   *   * *       *   * * * * *
* *** *** * * * ***** ********* ******* * * *** ***** *** ***** *** *** * * * * *** *** * *** * * * *
* *     * * * *     *   * *     * *     *     *               *   *     * * * * * * *   *   *   * * *
* *** * ***** *********** *** * * *********** ******* ***** * ***** ******* *** * *** *** ***** * ***
*   * *   *         *         *   * *   *   *   *     *     * *       *       *   *     *       * * *
* * ***** ********* ***** ***** *** *** *** *** ********* * ******* ***** * * * ***** ******* *** * *
* * *   * *   *         * * * *             * *   * *     * *     * * * * * * *           *     *   *
* *** *** * *** * * * *** * * ************* * * * * ********* *** * * * *** * * * * ******* ***** * *
* * * * * * *   * * *     *         *       * * * *   * * *   * * * *   * * *   * *     *     * * * *
* * * * * * ******* *********** * * * * ***** * *** *** * * *** * *** *** * * * *** *** * * *** * * *
* *       *     * *     *       * *   *   *     *   *         *   *         * *   * * *   * * *   * *
* ***** ******* * * ******* * * *** ***** *** *** ***** * * ***** * ***** * *** ***** ******* * *****
*   * * * * *   *       * *   *   * *   * * *       *   * *   *   *   * * *   *     * *   *   *     *
* * * * * * *** * ******* ********* *** * * * * ***** *** ***** * ***** *** * ***** * *** * ******* *
* *     * * * *   *       * *   *     * * *   *   * * *   * * * *         * *   * *   *         *   *
* ******* * * * * *** ***** * ***** *** *** * ***** * * *** * *** * * * ******* * * *** ***** * * * *
* *     * *   * * *   *   *       *   *     *   *   * *     *   * * * *   *     * *   * *     * * * *
* ***** * *** * * *** * ******* * * *** * *** * *** * ******* * * *** *** * ***** * ***** *** ***** *
* *   *   *     *     *   * * *     *   * * * *     *   *   * *     *   *       * * *     *     *   *
* *** *** * * *** *** *** * * * * ******* * * * ******* * *** * *** ******* * * * ***** ***** *** * *
*         * * *   *     *       *       * *   *   *         * * * * *       * *   *       *   *   * *
* * ***** ***** ************* ******* * * * * ***** *** ******* * ******* ***** *** ******* * * *** *
* * *     * *   *           *     *   * * * *     *   *   *     * *     *   *   *     *   * * * *   *
* ***** *** *** * *** *** * * *** *** * * ********* ***** * * * * * ***** ***** * *** *** ***** *** *
* * *         * * *   *   *     *   * * * *             * * * * *       * *     * * * *   * * * * * *
* * * * *** *********** *** * * *********** * ********* *** * ******* * ***** *** * *** * * * *** * *
*   * * *   *   *   *     * * * *       *   *     *     * * * *     * *     * *       * *   * * *   *
* *** * * * * *** ******* * * * * ***** *** *** *** ***** ***** *** * ******* *** * *** *** * * *** *
*   * * * * *         * * * * *   * *       *     *   *   *   * *       *     *   *     *   * *   * *
* * ******* * * ***** * ***** *** * ***** ******* * ***** * *** * *** ******* * *** * *** * * * *** *
* * *     * * * *               * * *   *     * * * *     *   * * * *         * * * * *   * *   *   *
*** * * * *** * * ***** ***** ***** *** * *** * *** *** ***** * * * ********* *** * ***** ***** *** *
* * *   * *   * * * *     *   *       * *   * *         *     * * * *   *       *   * *             *
* * * * ***** ***** ***** *** ***** * * ******* *** ***** *** * * * * ***** ********* ***** ***** * *
* *   * *     * *   *     *   *   * *   *     * * * * *     * * * * * *       *       *   * *   * * *
* * ***** *** * *** * *** *** *** *** *** ***** * *** * ***** * * * * ********* * ******* *** *******
*   *   *   *     *     *   *             *   *         *     * *   * *         *   * * * *       * *
*** *** * *********** * * *** ***** ******* * *** ************* *** * * *********** * * * *** * *** *
*           *   *   * * * *     * *   *   * *       * * *       *   *     * *     *     * *   *     *
* * * * ***** ***** * ********* * * *** ***** ******* * * * ******* *** *** ***** * * * * * ******* *
* * * *         *       *   * *   * *   * *       *   * * * *   *     * *     *     * *         * * *
* ***** *** *********** * *** * ***** *** ******* *** * *** * * * *** * ***** *** ***** ***** *** * *
* * *   * *       * *     *   *     * *             *   *     * * *     * * * * * *   * *   * *     *
* * * * * ***** *** *** *** ********* * ***** ******* * *** * * ***** * * * * * *** ******* ******* *
* *   * *   * * *     *       *     *     *   *   *   * *   * *     * *           *   *   *     * * *
* * ***** * * *** ********* *** ***** ***** *** * *** ******* * *** *************** * *** *** *** * *
* *     * *     *     *   *   * *         *     *     * *     *   *         *       *       *       *
*** * * * *** ***** * * ***** * *** ********* *** * * * * ***** ***** ******* ******* ***** * ***** *
*   * *   * * *     *     *       *     *     * * * * * * * * *   *       *     * * * * * *   *   * *
* *** * * * *********** ***** *** * *** *** * * ******* *** * * * *** * ********* * * * * * ***** * *
*   * * * *   * *     * *   * *     * *   * *         *   *     * *   *     *   *         * * * *   *
* ******* *** * *** * * * * * *** *** * ***** *** *** *** ***** ***** ***** * * * *** *** *** * *** *
* *   * * * *   *   * * *     *     *       *   * *   * *       *     * * * * * * *     *   *     * *
* * *** *** * ******* * * * * * ******* ********* * *** * ********* *** * ***** *** *** ***** ***** *
*     *         *         * * * *   *         *   * *       *   *   * *   *     * *   * *           *
***** * *** * * *** ***** *** * * ***** *** * * *** *** *** * ******* * ******* * * * ******* * *****
*   * *   * * *   * *   *   * *     *   *   *     * *   *   *     *   * *   *       * *       * *   *
* *** * ***** ***** * ******* *********** *** ***** * * * ******* * *** * * *** *** *** ******* * * *
* *   * *   * *   *   *     *   * * *       * *   *   * *   * *   *     * *     *     * *     * * * *
* * *** * * *** ******* * *** *** * *** *** * * * *** *** * * * ***** ***** *** ***** * *** * * * * *
* *     * *       * *   *         * *   * * *   *   * * * * *               *   *   * *   * *     * *
* *** ***** ******* * * * ***** * * * * * * * ***** *** * *** ***** ***** ********* * *** *** ***** *
*     *         *     *   *   * *       *   *   * * *   * *   *         *   *       * *     * *   * *
* ******* *** *** *** ******* * ********* ***** * *** * * * * * *** *********** * * * *********** * *
*   * *     * *   *       *   * *   * *       * *   * *     * * *     * *   * * * * * *     * * *   *
* *** *** * *** ***** ******* *** *** * * ***** * ********* * *** ***** *** * * *** *** *** * * *** *
* *       * *       *   *           * * * * * * * * * *   * * * * * * *   * *     *       *         *
* * * *********** * * *** * ********* ***** * * * * * * * * * * *** * * * * *** ***** *** *** ***** *
*   * * *       * * *   * *   *   * *   * *     * *     * * *       * * *     * * *   *   *   * * * *
* ***** *** * * * *** ***** *** *** * *** *** *** ***** * * ***** * * * * * ***** ***** *** *** * ***
* *   *     * * *         *       * *           * * * * *     * * *     * *   *   *     *   *     * *
* *** *** *** *** *** ******* * * * ***** * ***** * * *** *** * *** * *** * *** ******* ***** *** * *
*   *       *   * * *     * * * * *       * *         *     *   *   *   * *     *       * *     *   *
* *** * ******* * * *** *** ***** *** ***** * *********** * *** ******* *** * ***** *** * *** * * * *
* * * * *       *   * *     * * *   *   * *   * *       * * *     *     * * *     * *     *   * * * *
* * ********* * * * * * ***** * *** *** * ***** ******* * * ********* * * * * * * *** ***** ******* *
* * * * * *   *   * * *       * * *   *     * *   *     * *     *     * * * * * *             *   * *
* * * * * ********* * ***** * * * *** * * * * * ***** *** * * * ********* ************* ******* *** *
* *     *     *       *     *     *   * * * * *   *   *   * * *   *   *   *   *   * * *   *     * * *
* *** ***** * * * * *** ******* ***** * * * * * * *** * ***** * *** ***** * *** *** * * ***** *** * *
*   *   *   *   * * *   * * * *       * * * * * * * * * *   * * *       *   *       *   * *         *
*** * ***************** * * * *** * *** *** * * *** * * * *** * * *** * *** * ***** ***** *** ***** *
*                         *       *     *   *           *     *   *   *         *             *     *
************************************************** **************************************************
